#######
#     #
# ### #
#   #X#
# #####
     ##
A######
